##########################
#         #            # #
#######	  ######  ###  # #
#     #	###       # #### #
####         #### #      #
#  #####        #    #   #
#  #         # 	#    #   #
#  ####	   ############	 #
#               #  #     #
# #############    ##### #
#    #  #          #  #	 #
#       #             #	 #
##########################